繁体字	规范字	异体字
㑳	㑇	
㘚	㘎	
㠣	𫵷	
㥮	㤘	
㩳	㧐	
䃮	鿎	
䓣	𬜯	
䡵	𫟦	
䥑	鿏	
䥕	𬭯	
䮄	𫠊	
䰾	鲃	
䲁	鳚	
䲘	鳤	
䴉	鹮	
万		
丐		匃匄
丑		
丘		坵
丫		枒椏
丰		
乃		廼迺
乘		乗椉
乾	干	乹乾
亂	乱	
了		
云		
亘		亙
亞	亚	
亡		亾
享		亯
仆		
仇		讐讎
仙		僊
以		㕥㠯
仿		倣髣
伙		
伫		佇竚
似		佀
余		
佛		彿髴
你		妳
侃		偘
侄		妷姪
來	来	
侖	仑	崘崙
係	系	
俊		㑺儁
俔	伣	
俟		竢
俠	侠	
修		脩
俯		俛頫
倀	伥	
倆	俩	
倈	俫	
倉	仓	
個	个	箇
倏		倐儵
們	们	
借		
倦		勌
倫	伦	
假		叚
偉	伟	
偬		傯
側	侧	
偵	侦	遉
偷		媮
傖	伧	
傘	伞	𠌂繖
備	备	俻
傢	家	
傭	佣	
傳	传	
傴	伛	
債	债	
傷	伤	
傾	倾	
僂	偻	
僅	仅	
僉	佥	
僑	侨	
僕	仆	
僞	伪	
僤	𫢸	
僥	侥	儌
僨	偾	
僵		殭
價	价	
儀	仪	
儂	侬	
億	亿	
儈	侩	
儉	俭	
儐	傧	
儔	俦	
儕	侪	
儘	尽	
償	偿	
優	优	
儲	储	
儷	俪	
儺	傩	
儻	傥	
儼	俨	
克		
兒	儿	
兔		兎兔
党		
兜		兠
兩	两	
冉		冄
册		冊
再		𠕂𠕅
冒		冐
冗		宂
冢		塚
冤		𡨘寃
冥		𠖇㝠
冬		
冰		氷
冲		
决		決
况		況
净		淨
凄		淒悽
准		
凉		涼
凍	冻	
减		減
凑		湊
几		
凡		凢
凱	凯	
凳		櫈
凶		兇
出		
函		圅
刊		栞
划		
删		刪
刨		鉋鑤
别		
刮		
制		
券		劵
剃		薙鬀
剄	刭	
則	则	
剋	克	尅
剗	刬	
剛	刚	
剩		賸
剮	剐	
剴	剀	
創	创	剏剙
剿		𠞰勦
劃	划	
劇	剧	
劉	刘	
劊	刽	
劌	刿	
劍	剑	劒
劑	剂	
劫		刦刧刼
勁	劲	
動	动	働
勖		勗
務	务	
勛	勋	勳
勝	胜	
勞	劳	
勢	势	
勣	𪟝	
勤		懃
勩	勚	
勱	劢	
勵	励	
勸	劝	
匆		怱悤
匝		帀
匭	匦	
匯	汇	滙
匱	匮	
匹		疋
區	区	
千		
升		昇陞
卒		䘚
協	协	
博		愽
卜		
占		佔
卮		巵
卯		夘戼
却		㕁卻
卷		
厄		戹阨
厘		釐
厙	厍	
厠	厕	廁
厢		廂
厦		廈
厨		㕑廚
厩		廐廄
厭	厌	
厮		廝
厲	厉	
厴	厣	
參	参	㕘葠蓡
叙		敍敘
叠		㬪曡疊
叢	丛	
叩		敂
叫		呌
台		
叶		
吁		
吃		喫
合		
吊		弔
同		仝衕
后		
向		
吝		恡
吟		唫
吻		脗
呆		獃
周		週
呼		虖嘑謼
命		𠇮
和		咊龢
咏		詠
咒		呪
咤		吒
咩		𠴟
咬		齩
咱		倃𠴰偺喒
咳		欬
咸		
咼	呙	
咽		嚥
咿		吚
哄		閧鬨
員	员	
哲		喆
唄	呗	
唇		脣
唣		唕
問	问	
啓	启	唘啟
啖		啗噉
啞	哑	
啧		眥
啼		嗁
喂		餧餵
喋		啑
喑		瘖
喧		諠
喪	丧	
喬	乔	
單	单	
喲	哟	
嗆	呛	
嗇	啬	
嗊	唝	
嗎	吗	
嗚	呜	
嗥		嘷獋
嗩	唢	
嗶	哔	
嗽		𠻳
嘆	叹	歎
嘍	喽	
嘎		嘠
嘔	呕	
嘖	啧	
嘗	尝	甞嚐
嘜	唛	
嘩	哗	譁
嘮	唠	
嘯	啸	
嘰	叽	
嘵	哓	
嘸	呒	
嘻		譆
嘽	啴	
噁	恶𫫇	
噝	咝	
噠	哒	
噥	哝	
噦	哕	
噪		譟
噯	嗳	
噲	哙	
噴	喷	
噸	吨	
噹	当	
嚀	咛	
嚇	吓	
嚕	噜	
嚙	啮	齧囓
嚦	呖	
嚨	咙	
嚮	向	曏
嚲	亸	
嚳	喾	
嚴	严	
嚶	嘤	
囀	啭	
囁	嗫	
囂	嚣	
囅	冁	
囈	呓	
囉	啰	
囌	苏	
囑	嘱	
回		
因		囙
困		
圇	囵	
國	国	
圍	围	
園	园	
圓	圆	
圖	图	
團	团	
址		阯
坂		阪岅
坎		埳
坑		阬
坤		堃
坳		㘭
垛		垜
垻	坝	
埡	垭	
埨	𫭢	
執	执	
堅	坚	
堊	垩	
堙		陻
堝	埚	
堤		隄
堯	尧	
報	报	
場	场	塲
塊	块	
塋	茔	
塍		堘
塏	垲	
塒	埘	
塔		墖
塗	涂	
塢	坞	隖
塤	埙	壎
塵	尘	
塸	𫭟	
塹	堑	
塿	𪣻	
墊	垫	
墜	坠	
墠	𫮃	
墩		墪
墮	堕	
墳	坟	
墶	垯	
墻	墙	牆
墾	垦	
壇	坛	
壋	垱	
壓	压	
壘	垒	
壙	圹	
壚	垆	
壞	坏	
壟	垄	
壢	坜	
壩	坝	
壪	塆	
壯	壮	
壺	壶	
壼	壸	
壽	寿	
夜		亱
够		夠
夢	梦	
夥	伙	
夭		殀
夸		
夾	夹	袷裌
奔		奔逩犇
奩	奁	匲匳籨
奪	夺	
奬	奖	獎
奮	奋	
奶		妳嬭
奸		姦
妊		姙
妒		妬
妙		玅
妝	妆	粧
姊		姉
姗		姍
姜		
姻		婣
娘		孃
娙	𫰛	
婀		娿
婁	娄	
婦	妇	媍
婪		惏
婭	娅	
婿		壻
媧	娲	
媽	妈	
嫗	妪	
嫩		嫰
嫵	妩	
嫻	娴	嫺
嫿	婳	
嬀	妫	
嬃	媭	
嬈	娆	
嬋	婵	
嬌	娇	
嬙	嫱	
嬡	嫒	
嬪	嫔	
嬰	婴	
嬸	婶	
孌	娈	
孫	孙	
學	学	
孽		孼
孿	孪	
它		牠
宴		醼讌
家		
宿		㝛
寇		𭁵𡨥
寓		庽
察		詧
寢	寝	寑
實	实	寔
寧	宁	寕甯
寨		砦
審	审	
寫	写	
寬	宽	
寵	宠	
寶	宝	寳
射		䠶
將	将	
專	专	耑
尋	寻	𡬶
對	对	
導	导	
尷	尴	
尸		屍
局		侷跼
届		屆
屓	屃	
屢	屡	
層	层	
屨	屦	
屬	属	
岡	冈	
岩		嵒巗巖
岳		嶽
岸		㟁
峒		峝
峨		峩
峭		陗
峰		峯
峴	岘	
島	岛	㠀
峽	峡	
崍	崃	
崗	岗	
崬	岽	
嵐	岚	
嵽	𫶇	
嶁	嵝	
嶄	崭	嶃
嶇	岖	
嶔	嵚	
嶗	崂	
嶠	峤	
嶢	峣	
嶧	峄	
嶨	峃	
嶮	崄	
嶸	嵘	
嶺	岭	
嶼	屿	
巋	岿	
巒	峦	
巔	巅	
巘	𪩘	
巡		廵
巨		鉅
巰	巯	
布		佈
帆		㠶颿
帘		
帙		袟袠
帚		箒
帥	帅	
師	师	
席		蓆
帳	帐	
帶	带	
帽		㡌
幀	帧	
幂		冪
幃	帏	
幕		幙
幗	帼	
幘	帻	
幟	帜	
幣	币	
幫	帮	幇幚
幬	帱	
干		
年		秊
并		併並竝
幸		倖
幹	干	榦
幾	几	
床		牀
庫	库	
庵		菴
庶		庻
廉		亷㢘
廎	庼	
廞	𫷷	
廟	庙	
廠	厂	
廡	庑	
廢	废	癈
廣	广	
廬	庐	
廳	厅	
异		異
弃		棄
弄		挵衖
弊		𡚁
弦		絃
張	张	
强		強彊
彄	𫸩	
彆	别	
彈	弹	
彌	弥	
彎	弯	
彙	汇	
彠	彟	
彩		綵
往		徃
征		
徇		狥
後	后	
徑	径	逕
從	从	
徠	徕	
御		
復	复	
徵	征	
德		惪
徹	彻	
徽		幑
志		誌
忤		啎
念		唸
怪		恠
恍		怳
恒		恆
恤		卹䘏賉
恩		㤙
恿		惥慂
悍		猂
悖		誖
悴		顇
悵	怅	
悶	闷	
惇		㥫
惡	恶	
惱	恼	
惲	恽	
惻	恻	
愆		諐
愈		瘉癒
愛	爱	
愜	惬	㥦
愧		媿
愴	怆	
愷	恺	
愾	忾	
態	态	
慎		昚
慘	惨	
慚	惭	慙
慟	恸	
慣	惯	
慤	悫	
慨		嘅
慪	怄	
慫	怂	
慮	虑	
慳	悭	
慶	庆	
憂	忧	
憊	惫	
憐	怜	
憑	凭	凴
憒	愦	
憔		癄顦
憖	慭	
憚	惮	
憤	愤	
憩		憇
憫	悯	
憮	怃	
憲	宪	
憶	忆	
懇	恳	
應	应	
懌	怿	
懞	蒙	
懟	怼	
懣	懑	
懨	恹	
懲	惩	
懶	懒	嬾
懷	怀	
懸	悬	
懺	忏	
懼	惧	
懾	慑	慴
戀	恋	
戇	戆	
戔	戋	
戚		慽慼
戛		戞
戧	戗	
戮		剹
戰	战	
戲	戏	戯
才		
扎		紥紮
托		託
扛		摃
扣		釦
扯		撦
扼		搤
折		
抵		牴觝
拐		柺
拓		搨
拖		拕
拗		抝
括		𢬸
拿		拏㧱挐
挂		𦊱掛
挲		挱
挽		輓
挾	挟	
捆		綑
捍		扞
捏		揑
捨	舍	
捫	扪	
据		
捲	卷	
捶		搥
捷		㨗
掃	扫	
掄	抡	
掏		搯
揀	拣	
插		揷
揚	扬	敭颺
揪		揫
揮	挥	
損	损	
搗	捣	𢷬擣
搜		蒐
搶	抢	
携		擕㩗㩦攜
摑	掴	
摜	掼	
摟	搂	
摯	挚	
摳	抠	
摶	抟	
摺	折	
摻	掺	
撈	捞	
撏	挦	
撑		撐
撓	挠	
撝	㧑	
撣	掸	
撥	拨	
撫	抚	
撰		譔
撲	扑	
撳	揿	搇
撻	挞	
撾	挝	
撿	捡	
擁	拥	
擄	掳	
擇	择	
擊	击	
擋	挡	攩
操		𢮥
擓	㧟	
擔	担	
據	据	㨿
擠	挤	
擬	拟	儗
擯	摈	
擰	拧	
擱	搁	
擲	掷	
擴	扩	
擷	撷	
擺	摆	
擻	擞	
擼	撸	
擾	扰	
攄	摅	
攆	撵	
攏	拢	
攔	拦	
攖	撄	
攙	搀	
攛	撺	
攝	摄	
攢	攒	
攣	挛	
攤	摊	
攪	搅	
攬	揽	
效		効傚
救		捄
敕		勅勑
敗	败	
散		㪚
敦		㪟
敵	敌	
數	数	
斂	敛	歛
斃	毙	獘
斆	敩	
斕	斓	
斗		
斤		觔
斫		斮斲斵
斬	斩	
斷	断	
旋		
旗		旂
昆		崐崑
昏		昬
映		暎
春		旾
是		昰
昵		暱
時	时	旹
晃		㨪
晋		晉
晛	𬀪	
晝	昼	
晰		晳
暈	晕	
暉	晖	
暐	𬀩	
暖		㬉煗煖
暗		晻闇
暘	旸	
暢	畅	
暫	暂	蹔
曄	晔	
曆	历	厤
曇	昙	
曉	晓	
曖	暧	
曠	旷	
曨	昽	
曬	晒	
曲		
書	书	
最		冣㝡
會	会	
望		朢
期		朞
朧	胧	
札		剳劄
术		
朱		
朴		
朵		朶
杆		桿
村		邨
杠		槓
杯		盃桮
杰		傑
東	东	
松		
板		
果		菓
柏		栢
查		査
柳		栁桺
柿		柹
栀		梔
栅		柵
栖		棲
栗		慄
核		覈
桌		槕
桑		桒
梁		樑
梅		楳槑
梘	枧	
梜	𬂩	
條	条	
梟	枭	
梨		棃
棋		棊碁
棕		椶
棖	枨	
棗	枣	
棟	栋	
棡	㭎	
棧	栈	
棰		箠
棱		稜
棶	梾	
棹		櫂
椁		槨
椏	桠	
楊	杨	
楓	枫	
楠		枏柟
楦		楥
楨	桢	
楫		檝
業	业	
極	极	
概		㮣
榜		牓
榨		搾
榪	杩	
榮	荣	
榷		搉𣙜
榿	桤	
槁		槀
構	构	搆
槍	枪	鎗
槤	梿	
槧	椠	
槳	桨	
樁	桩	
樂	乐	
樅	枞	
樓	楼	
標	标	
樞	枢	
樣	样	
樸	朴	
樹	树	
樺	桦	
樽		罇
橈	桡	
橋	桥	
橛		橜
機	机	
橢	椭	
橱		櫥
檉	柽	
檐		簷
檔	档	
檜	桧	
檟	槚	
檢	检	
檣	樯	艢
檮	梼	
檯	台	
檳	槟	
檸	柠	
檻	槛	
櫃	柜	
櫍	𬃊	
櫓	橹	樐㯭艣艪
櫚	榈	
櫛	栉	
櫝	椟	
櫞	橼	
櫟	栎	
櫧	槠	
櫨	栌	
櫪	枥	
櫬	榇	
櫳	栊	
櫸	榉	
櫻	樱	
欄	栏	
權	权	
欏	椤	
欒	栾	
欓	𣗋	
欖	榄	
欞	棂	
欣		訢
欲		慾
欽	钦	
款		欵
歌		謌
歐	欧	
歟	欤	
歡	欢	懽讙驩
歲	岁	嵗
歷	历	歴𠪱
歸	归	
殘	残	
殞	殒	
殤	殇	
殫	殚	
殮	殓	
殯	殡	
殲	歼	
殷		慇
殺	杀	
殻	壳	
毁		燬譭
毆	殴	
毗		毘
毿	毵	
氈	毡	氊
氌	氇	
氛		雰
氣	气	
氫	氢	
氬	氩	
污		汙汚
汹		洶
沈		
沾		霑
泄		洩
法		㳒灋
泛		氾汎
注		註
泪		淚
泯		冺
浙		淛
浚		濬
浣		澣
浹	浃	
浿	𬇙	
涂		
涅		湼
涇	泾	
涌		湧
涎		㳄
淀		
淆		殽
淋		痳
淪	沦	
淫		婬滛滛右上从類似月字
深		㴱
淳		湻
淵	渊	
淶	涞	
淺	浅	
渢	沨	
渦	涡	
測	测	
游		遊
渺		淼𣺌
渾	浑	
湋	𣲗	
湞	浈	
湯	汤	
準	准	
溝	沟	
溪		谿
溮	浉	
溯		泝遡
溳	涢	
滄	沧	
滅	灭	
滌	涤	
滎	荥	
滬	沪	
滯	滞	
滲	渗	
滷	卤	
滸	浒	
滻	浐	
滿	满	
漁	渔	
漊	溇	
漍	𬇹	
漓		
漚	沤	
漢	汉	
漣	涟	
漬	渍	
漱		潄
漲	涨	
漸	渐	
漿	浆	
潁	颍	
潑	泼	
潔	洁	絜
潕	𣲘	
潙	沩	
潜		潛
潤	润	
潯	浔	
潰	溃	
潷	滗	
潿	涠	
澀	涩	澁濇
澄		澂
澆	浇	
澇	涝	
澐	沄	
澗	涧	
澠	渑	
澤	泽	
澦	滪	
澫	𬇕	
澮	浍	
澱	淀	
濁	浊	
濃	浓	
濆	𣸣	
濕	湿	溼
濘	泞	
濚	溁	
濛	蒙	
濜	浕	
濟	济	
濤	涛	
濫	滥	
濰	潍	
濱	滨	
濺	溅	
濼	泺	
濾	滤	
瀂	澛	
瀅	滢	
瀆	渎	
瀉	泻	
瀋	沈	
瀏	浏	
瀕	濒	
瀘	泸	
瀝	沥	
瀟	潇	
瀠	潆	
瀧	泷	
瀨	濑	
瀰	弥	
瀲	潋	
瀾	澜	
灃	沣	
灄	滠	
灑	洒	
灕	漓	
灘	滩	
灝	灏	
灣	湾	
灤	滦	
灧	滟	
灾		災烖菑
炕		匟
炮		砲礮
炯		烱
烏	乌	
烟		菸煙
烴	烃	
焊		釬銲
無	无	
焰		燄
煉	炼	鍊
煒	炜	
煢	茕	
照		炤
煩	烦	
煬	炀	
煮		煑
熏		燻
熒	荧	
熗	炝	
熙		𤋮熈
熰	𬉼	
熱	热	
熲	颎	
熾	炽	
燀	𬊤	
燁	烨	爗
燈	灯	
燒	烧	
燕		鷰
燖	𬊈	
燙	烫	
燜	焖	
營	营	
燦	灿	
燭	烛	
燮		爕
燴	烩	
燼	烬	
燾	焘	
爍	烁	
爐	炉	鑪
爛	烂	
爲	为	
爺	爷	
爾	尔	尒
牘	牍	
牦		犛氂
牽	牵	
犁		犂
犖	荦	
犢	犊	
犧	牺	
狀	状	
狷		獧
狸		貍
狹	狭	陿
狽	狈	
猪		豬
猫		貓
猬		蝟
猶	犹	
猻	狲	
猿		猨蝯
獁	犸	
獄	狱	
獅	狮	
獐		麞
獨	独	
獪	狯	
獫	猃	
獮	狝	
獰	狞	
獲	获	
獵	猎	
獷	犷	
獸	兽	
獺	獭	
獻	献	
獼	猕	
獾		䝔貛
玀	猡	
玩		翫
玳		瑇
珊		珊
珍		珎
珐		琺
現	现	
球		毬
琅		瑯
琉		瑠璢
琴		琹
琿	珲	
瑋	玮	
瑒	玚	
瑣	琐	𤨏
瑩	莹	
瑪	玛	
瑰		瓌
瑲	玱	
璃		琍瓈
璇		璿
璉	琏	
璊	𫞩	
璕	𬍤	
璗	𬍡	
璡	琎	
璣	玑	
璦	瑷	
璫	珰	
環	环	
璵	玙	
璽	玺	
瓅	𬍛	
瓊	琼	
瓏	珑	
瓔	璎	
瓚	瓒	
瓛	𤩽	
瓮		甕罋
瓶		缾
甌	瓯	
産	产	
留		𤱊㽞畱
畝	亩	𤰜畂𤱈畆畮
畢	毕	
略		畧
畫	画	
當	当	
疇	畴	
疏		疎
疱		皰
疴		痾
症		
痙	痉	
痱		疿
痴		癡
痹		痺
瘋	疯	
瘍	疡	
瘞	瘗	
瘡	疮	
瘤		癅
瘧	疟	
瘩		𤺥
瘮	瘆	
瘲	疭	
瘻	瘘	
療	疗	
癆	痨	
癇	痫	
癉	瘅	
癘	疠	
癟	瘪	㿜
癢	痒	
癤	疖	
癥	症	
癧	疬	
癩	癞	
癬	癣	
癭	瘿	
癮	瘾	
癰	痈	
癱	瘫	
癲	癫	
發	发	
皂		皁
皋		皐臯
皓		暠皜
皚	皑	
皸	皲	
皺	皱	
盍		盇
盞	盏	琖醆
盡	尽	
監	监	
盤	盘	
盧	卢	
眇		𦕈
眯		瞇
眷		睠
眺		覜
睍	𪾢	
睏	困	
睞	睐	
睬		倸
睹		覩
睿		叡
瞅		𥄨矁
瞘	眍	
瞜	䁖	
瞞	瞒	
瞭	了	
瞰		矙
瞼	睑	
矇	蒙	
矓	眬	
矚	瞩	
矩		榘
矯	矫	
砧		碪
硃	朱	
硜	硁	
硤	硖	
硨	砗	
硯	砚	
碇		矴椗
碌		磟
碗		㼝盌椀
碩	硕	
碭	砀	
碰		掽踫
碱		堿鹻鹼
碴		𦉆
碸	砜	
確	确	
碼	码	
磑	硙	
磚	砖	塼甎
磣	碜	
磧	碛	
磯	矶	
磷		粦燐
磽	硗	
磾	䃅	
礄	硚	
礎	础	
礐	𬒈	
礙	碍	
礦	矿	鑛
礪	砺	
礫	砾	
礬	矾	
礱	砻	
祀		禩
禀		稟
禍	祸	旤
禎	祯	
禕	祎	
禡	祃	
禦	御	
禪	禅	
禮	礼	
禰	祢	
禱	祷	
秆		稈
秋		秌𥤚
种		
秕		粃
秘		祕
秸		稭
移		迻
稗		粺
稚		稺穉
種	种	
稱	称	
稿		稾
穀	谷	
穇	䅟	
穌	稣	
積	积	
穎	颖	頴
穠	秾	
穡	穑	
穢	秽	
穩	稳	
穫	获	
窑		窰窯
窗		窓𥦗牎牕窻
窩	窝	
窪	洼	
窮	穷	
窵	窎	
窶	窭	
窺	窥	闚
竄	窜	
竅	窍	
竇	窦	
竈	灶	
竊	窃	
竪	竖	豎
競	竞	
笋		筍
笑		咲
筆	笔	
筏		栰
筑		
筒		筩
策		筴筞
筧	笕	
筲		䈰
箋	笺	牋椾
管		筦
箬		篛
箸		筯
節	节	
範	范	
築	筑	
篋	箧	
篔	筼	
篡		簒
篢	𬕂	
篤	笃	
篩	筛	
篱		
篳	筚	
簀	箦	
簍	篓	
簞	箪	
簡	简	
簣	篑	
簪		簮
簫	箫	
簹	筜	
簽	签	
簾	帘	
籃	篮	
籌	筹	
籙	箓	
籛	篯	
籜	箨	
籟	籁	
籠	笼	
籤	签	
籩	笾	
籪	簖	
籬	篱	
籮	箩	
籲	吁	
籼		秈
粗		觕麤
粳		秔粇稉
粽		糉
糇		餱
糊		䊀餬
糍		餈
糕		餻
糖		餹
糝	糁	
糞	粪	
糟		蹧
糠		粇穅
糧	粮	
糯		稬穤
糰	团	
糲	粝	
糴	籴	
糶	粜	
系		
糾	纠	糺
紀	纪	
紂	纣	
紃	𬘓	
約	约	
紅	红	
紆	纡	
紇	纥	
紈	纨	
紉	纫	
紋	纹	
納	纳	
紐	纽	
紓	纾	
純	纯	
紕	纰	
紖	纼	
紗	纱	
紘	纮	
紙	纸	帋
級	级	
紛	纷	
紜	纭	
紝	纴	
紞	𬘘	
紡	纺	
累		
細	细	
紱	绂	
紲	绁	絏
紳	绅	
紵	纻	
紹	绍	
紺	绀	
紼	绋	
紿	绐	
絀	绌	
終	终	
組	组	
絅	䌹	
絆	绊	
絎	绗	
結	结	
絝	绔	
絞	绞	
絡	络	
絢	绚	
給	给	
絨	绒	毧羢
絪	𬘡	
絰	绖	
統	统	
絲	丝	
絳	绛	
絶	绝	
絹	绢	
絺	𫄨	
綁	绑	
綃	绡	
綄	𬘫	
綆	绠	
綈	绨	
綉	绣	繡
綌	绤	
綎	𬘩	
綏	绥	
經	经	
綖	𫄧	
綜	综	
綝	𬘭	
綡	𫟅	
綢	绸	紬
綣	绻	
綧	𬘯	
綪	𬘬	
綫	线	線
綬	绶	
維	维	
綯	绹	
綰	绾	
綱	纲	
網	网	
綳	绷	繃
綴	缀	
綸	纶	
綹	绺	
綺	绮	
綻	绽	
綽	绰	
綾	绫	
綿	绵	緜
緄	绲	
緇	缁	
緊	紧	𦂳𦃂
緋	绯	
緑	绿	菉
緒	绪	
緔	绱	
緗	缃	
緘	缄	椷
緙	缂	
線	缐	
緝	缉	
緞	缎	
締	缔	
緡	缗	
緣	缘	
緦	缌	
編	编	
緩	缓	
緬	缅	
緯	纬	
緱	缑	
緲	缈	
練	练	
緹	缇	
緻	致	
緼	缊	
縈	萦	
縉	缙	
縊	缢	
縋	缒	
縐	绉	
縑	缣	
縗	缞	
縛	缚	
縝	缜	
縞	缟	
縟	缛	
縣	县	
縧	绦	絛縚
縫	缝	
縭	缡	
縮	缩	
縯	𬙂	
縱	纵	
縲	缧	
縴	纤	
縵	缦	
縶	絷	
縷	缕	
縹	缥	
總	总	
績	绩	勣
繁		緐
繅	缫	
繆	缪	
繒	缯	
織	织	
繕	缮	
繚	缭	
繞	绕	遶
繩	绳	
繪	绘	
繫	系	
繭	茧	蠒
繮	缰	韁
繯	缳	
繰	缲	
繳	缴	
繶	𫄷	
繹	绎	
繻	𦈡	
繼	继	
繽	缤	
繾	缱	
纁	𫄸	
纂		篹
纆	𬙊	
纈	缬	
纊	纩	
續	续	
纍	累	
纏	缠	
纓	缨	
纔	才	
纕	𬙋	
纖	纤	
纘	缵	
纜	缆	
罃	䓨	
罌	罂	甖
罎	坛	罈壜
罐		鑵
罔		㒺
罪		辠
置		寘
罰	罚	罸
罷	罢	
羅	罗	
羆	罴	
羈	羁	覊
羌		𦍑羗
群		羣
羥	羟	
義	义	
翅		翄
習	习	
翬	翚	
翱		翺
翳		瞖
翹	翘	
翻		繙飜
翽	翙	
耀		燿
考		攷
耕		畊
耬	耧	
耮	耢	
耻		恥
耽		躭
聖	圣	
聞	闻	
聯	联	
聰	聪	
聲	声	
聳	耸	
聵	聩	
聶	聂	
職	职	
聹	聍	
聽	听	
聾	聋	
肅	肃	
肛		疘
肯		肎
肴		餚
背		揹
胚		肧
胡		衚
胭		臙
胳		肐
胸		胷
脅	胁	脇
脆		脃
脉		脈䘑衇
脖		𩓐
脚		腳
脛		踁
脹	胀	
腌		醃
腎	肾	
腖	胨	
腡	脶	
腦	脑	
腫	肿	
腭		齶
腮		顋
腸	肠	膓
腿		骽
膀		髈
膕	腘	
膘		臕
膚	肤	
膝		厀
膞	䏝	
膠	胶	
膢	𦝼	
膩	腻	
膳		饍
膻		羴羶
膽	胆	
膾	脍	
膿	脓	
臀		臋
臉	脸	
臍	脐	
臏	膑	
臓	脏	
臘	腊	臈
臚	胪	
臠	脔	
臢	臜	
臨	临	
致		
臺	台	
與	与	
興	兴	
舉	举	擧
舊	旧	
舍		
船		舩
艙	舱	
艤	舣	
艦	舰	
艫	舻	
艱	艰	
艷	艳	豓豔
花		芲蘤
芸		
芻	刍	
苧	苎	
范		
草		艸
荔		茘
莅		涖蒞
莊	庄	
莖	茎	
莢	荚	
莧	苋	
華	华	
菱		蔆
萇	苌	
萊	莱	
萬	万	
萱		萲蕿蘐藼
萵	莴	
萼		蕚
葉	叶	
葒	荭	
葤	荮	
葦	苇	
葬		塟𦵏
葱		蔥
葷	荤	
蒂		蔕
蒓	莼	蓴
蒔	莳	
蒙		
蒼	苍	
蓀	荪	
蓋	盖	
蓑		簑
蓮	莲	
蓯	苁	
蓽	荜	
蔄	𬜬	
蔑		
蔔	卜	
蔞	蒌	
蔣	蒋	
蔦	茑	
蔭	荫	廕
蔿	𫇭	
蕁	荨	
蕆	蒇	
蕊		蕋橤蘂
蕎	荞	荍
蕒	荬	
蕓	芸	
蕕	莸	
蕘	荛	
蕢	蒉	
蕩	荡	盪
蕪	芜	
蕭	萧	
蕷	蓣	
薈	荟	
薊	蓟	
薌	芗	
薑	姜	
薔	蔷	
薘	荙	
薟	莶	
薦	荐	
薩	萨	
薯		藷
薴	苧	
薺	荠	
藉	借	
藍	蓝	
藎	荩	
藜		蔾
藝	艺	
藤		籐
藥	药	
藪	薮	
藭	䓖	
藴	蕴	
藶	苈	
藹	蔼	
藺	蔺	
蘀	萚	
蘄	蕲	
蘆	芦	
蘇	苏	甦蘓
蘋	苹𬞟	
蘚	藓	
蘞	蔹	
蘢	茏	
蘭	兰	
蘺	蓠	
蘿	萝	
虉	𬟁	
處	处	
虜	虏	虜
號	号	
虧	亏	
虬		虯
虱		蝨
虻		蝱
蚊		螡蟁
蚝		蠔
蛇		虵
蛔		蚘痐蛕蜖
蛙		鼃
蛺	蛱	
蜂		䗬蠭
蜆	蚬	
蝀	𬟽	
蝎		蠍
蝕	蚀	
蝦	虾	
蝶		蜨
蝸	蜗	
螂		蜋
螄	蛳	
融		螎
螞	蚂	
螢	萤	
螮	䗖	
螻	蝼	
蟄	蛰	
蟆		蟇
蟈	蝈	
蟎	螨	
蟣	虮	
蟬	蝉	
蟯	蛲	
蟲	虫	
蟶	蛏	
蟹		蠏
蟻	蚁	
蠅	蝇	
蠆	虿	
蠐	蛴	
蠑	蝾	
蠕		蝡
蠟	蜡	
蠢		惷
蠣	蛎	
蠨	蟏	
蠱	蛊	
蠶	蚕	
蠻	蛮	
衄		衂䶊
衆	众	眾
衊	蔑	
術	术	
衛	卫	
衝	冲	
表		
衹	只	祇秖
衽		袵
袒		襢
裊	袅	嫋褭嬝
裏	里	裡
裙		帬裠
補	补	
裝	装	
裸		躶臝
製	制	
複	复	
褌	裈	
褒		襃
褓		緥
褘	袆	
褲	裤	袴
褳	裢	
褸	褛	
褻	亵	
襀	𫌀	
襁		繦
襇	裥	
襏	袯	
襖	袄	
襝	裣	
襠	裆	
襤	褴	
襪	袜	韈韤
襬	摆	
襯	衬	
襲	袭	
襴	襕	
見	见	
覎	觃	
規	规	槼
覓	觅	覔
視	视	眎眡
覘	觇	
覡	觋	
覦	觎	
親	亲	
覬	觊	
覯	觏	
覲	觐	
覷	觑	
覺	觉	
覽	览	
覿	觌	
觀	观	
觴	觞	
觶	觯	
觸	触	
訂	订	
訃	讣	
計	计	
訊	讯	
訌	讧	
討	讨	
訏	𬣙	
訐	讦	
訒	讱	
訓	训	
訕	讪	
訖	讫	
記	记	
訛	讹	譌
訝	讶	
訟	讼	
訢	䜣	
訣	诀	
訥	讷	
訩	讻	
訪	访	
設	设	
許	许	
訴	诉	愬
訶	诃	
診	诊	
詁	诂	
詆	诋	
詎	讵	
詐	诈	
詒	诒	
詔	诏	
評	评	
詖	诐	
詗	诇	
詘	诎	
詛	诅	
詝	𬣞	
詞	词	䛐
詡	诩	
詢	询	
詣	诣	
試	试	
詩	诗	
詪	𬣳	
詫	诧	
詬	诟	
詭	诡	
詮	诠	
詰	诘	
話	话	䛡
該	该	
詳	详	
詵	诜	
詷	𫍣	
詼	诙	
詿	诖	
誄	诔	
誅	诛	
誆	诓	
誇	夸	
認	认	
誑	诳	
誕	诞	
誘	诱	
誚	诮	
語	语	
誠	诚	
誡	诫	
誣	诬	
誤	误	
誥	诰	
誦	诵	
誨	诲	
説	说	
誰	谁	
課	课	
誶	谇	
誹	诽	
誼	谊	
誾	訚	
調	调	
諂	谄	謟
諄	谆	
談	谈	
諉	诿	
請	请	
諍	诤	
諏	诹	
諑	诼	
諒	谅	
諓	𬣡	
論	论	
諗	谂	
諛	谀	
諜	谍	
諝	谞	
諞	谝	
諟	𬤊	
諢	诨	
諤	谔	
諦	谛	
諧	谐	
諫	谏	
諭	谕	
諱	讳	
諲	𬤇	
諳	谙	
諴	𫍯	
諶	谌	
諷	讽	
諸	诸	
諺	谚	
諼	谖	
諾	诺	
謀	谋	
謁	谒	
謂	谓	
謄	誊	
謅	诌	
謊	谎	
謎	谜	
謏	𫍲	
謐	谧	
謔	谑	
謖	谡	
謗	谤	
謙	谦	
謚	谡	諡
講	讲	
謝	谢	
謡	谣	
謨	谟	謩
謫	谪	讁
謬	谬	
謭	谫	
謳	讴	
謹	谨	
謾	谩	
證	证	
譎	谲	
譏	讥	
譓	𬤝	
譖	谮	
識	识	
譙	谯	
譚	谭	
譜	谱	
譞	𫍽	
譫	谵	
譯	译	
議	议	
譴	谴	
護	护	
譽	誉	
讀	读	
變	变	
讋	詟	
讎	雠	讐
讒	谗	
讓	让	
讕	谰	
讖	谶	
讜	谠	
讞	谳	
谷		
豆		荳
豈	岂	
豐	丰	
豶	豮	
貙	䝙	
貝	贝	
貞	贞	
負	负	
財	财	
貢	贡	
貧	贫	
貨	货	
販	贩	
貪	贪	
貫	贯	
責	责	
貯	贮	
貰	贳	
貲	赀	
貳	贰	
貴	贵	
貶	贬	
買	买	
貸	贷	
貺	贶	
費	费	
貼	贴	
貽	贻	
貿	贸	
賀	贺	
賁	贲	
賂	赂	
賃	赁	
賄	贿	
賅	赅	
資	资	貲
賈	贾	
賊	贼	
賑	赈	
賒	赊	
賓	宾	
賕	赇	
賙	赒	
賚	赉	
賜	赐	
賞	赏	
賠	赔	
賡	赓	
賢	贤	
賣	卖	
賤	贱	
賦	赋	
賧	赕	
質	质	
賫	赍	賷齎
賬	账	
賭	赌	
賴	赖	頼
賵	赗	
賺	赚	
賻	赙	
購	购	
賽	赛	
賾	赜	
贄	贽	
贅	赘	
贇	赟	
贈	赠	
贊	赞	賛讚
贋	赝	贗
贍	赡	
贏	赢	
贐	赆	
贔	赑	
贖	赎	
贛	赣	贑灨
贜	赃	
赬	赪	
趁		趂
趕	赶	
趙	赵	
趨	趋	
趲	趱	
跖		蹠
跺		跥
踐	践	
踩		跴
踪		蹤
踴	踊	
蹄		蹏
蹌	跄	
蹕	跸	
蹚		䠀
蹣	蹒	
蹰		躕
蹴		蹵
蹺	跷	蹻
躂	跶	
躉	趸	
躊	踌	
躋	跻	
躍	跃	
躑	踯	
躒	跞	
躓	踬	
躚	跹	
躡	蹑	
躥	蹿	
躦	躜	
躪	躏	
躬		躳
軀	躯	
車	车	
軋	轧	
軌	轨	
軍	军	
軏	𫐄	
軑	轪	
軒	轩	
軔	轫	軔
軛	轭	
軝	𬨂	
軟	软	輭
軤	轷	
軫	轸	
軲	轱	
軸	轴	
軹	轵	
軺	轺	
軻	轲	
軼	轶	
軾	轼	
較	较	
輄	𨐈	
輅	辂	
輇	辁	
輈	辀	
載	载	
輊	轾	
輋	𪨶	
輒	辄	輙
輔	辅	
輕	轻	
輗	𫐐	
輛	辆	
輜	辎	
輝	辉	煇
輞	辋	
輟	辍	
輥	辊	
輦	辇	
輩	辈	
輪	轮	
輬	辌	
輮	𫐓	
輯	辑	
輳	辏	
輶	𬨎	
輸	输	
輻	辐	
輼	辒	
輾	辗	
輿	舆	
轂	毂	
轄	辖	
轅	辕	
轆	辘	
轉	转	
轍	辙	
轎	轿	
轔	辚	
轟	轰	
轡	辔	
轢	轹	
轤	轳	
辟		
辣		辢
辦	办	
辭	辞	辤
辮	辫	
辯	辩	
農	农	辳
迥		逈
迫		廹
迴	回	廻逥
迹		跡蹟
逕	迳	
這	这	
連	连	
進	进	
逼		偪
逾		踰
遁		遯
運	运	
遍		徧
過	过	
達	达	
違	违	
遜	逊	
遞	递	
遠	远	
適	适	
遲	迟	
遷	迁	
選	选	
遺	遗	
遼	辽	
邁	迈	
還	还	
邇	迩	
邊	边	
邏	逻	
邐	逦	
邪		衺
郁		
郟	郏	
郵	邮	
鄆	郓	
鄉	乡	
鄒	邹	
鄔	邬	
鄖	郧	
鄧	邓	
鄩	𬩽	
鄭	郑	
鄰	邻	隣
鄲	郸	
鄳	𫑡	
鄴	邺	
鄶	郐	
鄺	邝	
酇	酂	
酈	郦	
酬		酧詶醻
醇		醕
醖	酝	
醜	丑	
醫	医	
醬	酱	
醱	酦	
醲	𬪩	
釀	酿	
釁	衅	
釃	酾	
釅	酽	
采		採寀
釋	释	
里		
野		埜𡐨
釓	钆	
釔	钇	
釕	钌	
釗	钊	
釘	钉	
釙	钋	
針	针	鍼
釣	钓	
釤	钐	
釧	钏	
釩	钒	
釴	𬬩	
釵	钗	
釷	钍	
釹	钕	
釺	钎	
釿	𬬱	
鈀	钯	
鈁	钫	
鈃	钘	
鈄	钭	
鈇	𫓧	
鈈	钚	
鈉	钠	
鈍	钝	
鈎	钩	鉤
鈐	钤	
鈑	钣	
鈔	钞	
鈕	钮	
鈞	钧	
鈣	钙	
鈥	钬	
鈦	钛	
鈧	钪	
鈮	铌	
鈰	铈	
鈴	铃	
鈷	钴	
鈸	钹	
鈹	铍	
鈺	钰	
鈾	铀	
鈿	钿	
鉀	钾	
鉅	钜	
鉈	铊	
鉉	铉	
鉊	𬬿	
鉍	铋	
鉑	铂	
鉕	钷	
鉗	钳	
鉚	铆	
鉛	铅	鈆
鉞	钺	
鉢	钵	盋缽
鉥	𬬸	
鉦	钲	
鉧	𬭁	
鉬	钼	
鉭	钽	
鉮	𬬹	
鉶	铏	
鉷	𫟹	
鉸	铰	
鉺	铒	
鉻	铬	
鉿	铪	
銀	银	
銃	铳	
銅	铜	
銈	𫓯	
銍	铚	
銑	铣	
銓	铨	
銖	铢	
銘	铭	
銚	铫	
銜	衔	啣衘
銠	铑	
銣	铷	
銥	铱	
銦	铟	
銨	铵	
銩	铥	
銪	铕	
銫	铯	
銬	铐	
銱	铞	
銶	𨱇	
銷	销	
銹	锈	鏽
銻	锑	
銼	锉	剉
鋁	铝	
鋃	锒	
鋅	锌	
鋇	钡	
鋌	铤	
鋏	铗	
鋐	𬭎	
鋒	锋	
鋗	𫓶	
鋙	铻	
鋝	锊	
鋟	锓	
鋣	铘	
鋤	锄	鉏耡
鋥	锃	
鋦	锔	
鋨	锇	
鋪	铺	舖
鋭	锐	
鋮	铖	
鋯	锆	
鋰	锂	
鋱	铽	
鋶	锍	
鋸	锯	
鋹	𬬮	
鋼	钢	
錀	𬬭	
錁	锞	
錆	锖	
錇	锫	
錈	锩	
錐	锥	
錒	锕	
錕	锟	
錘	锤	鎚
錙	锱	
錚	铮	
錛	锛	
錞	𬭚	
錟	锬	
錠	锭	
錡	锜	
錢	钱	
錤	𫓹	
錦	锦	
錨	锚	
錫	锡	
錮	锢	
錯	错	
録	录	
錳	锰	
錶	表	
錸	铼	
鍀	锝	
鍁	锨	
鍃	锪	
鍆	钔	
鍇	锴	
鍈	锳	
鍋	锅	
鍍	镀	
鍔	锷	
鍘	铡	
鍚	钖	
鍛	锻	
鍠	锽	
鍤	锸	
鍥	锲	
鍩	锘	
鍬	锹	鍫
鍭	𬭤	
鍰	锾	
鍵	键	
鍶	锶	
鍺	锗	
鍾	钟锺	
鎂	镁	
鎄	锿	
鎇	镅	
鎊	镑	
鎓	𬭩	
鎔	镕	
鎖	锁	鎻
鎘	镉	
鎛	镈	
鎝	𨱏	
鎡	镃	
鎢	钨	
鎣	蓥	
鎦	镏	
鎧	铠	
鎩	铩	
鎪	锼	
鎬	镐	
鎮	镇	
鎰	镒	
鎳	镍	
鎵	镓	
鎸	镌	
鎿	镎	
鏃	镞	
鏇	旋	
鏈	链	
鏌	镆	
鏏	𬭬	
鏐	镠	
鏑	镝	
鏗	铿	
鏘	锵	
鏜	镗	
鏝	镘	
鏞	镛	
鏟	铲	剷
鏡	镜	
鏢	镖	
鏤	镂	
鏨	錾	
鏰	镚	
鏵	铧	
鏷	镤	
鏹	镪	
鏺	䥽	
鏻	𬭸	
鐃	铙	
鐄	𨱑	
鐇	𫔍	
鐋	铴	
鐍	𫔎	
鐏	𨱔	
鐐	镣	
鐒	铹	
鐓	镦	
鐔	镡	
鐘	钟	
鐙	镫	
鐝	镢	
鐠	镨	
鐦	锎	
鐧	锏	
鐨	镄	
鐩	𬭼	
鐮	镰	鎌䥥
鐯	䦃	
鐲	镯	
鐳	镭	
鐵	铁	
鐶	镮	
鐸	铎	
鐺	铛	
鐽	𫟼	
鐿	镱	
鑄	铸	
鑊	镬	
鑌	镔	
鑒	鉴	鍳鑑
鑔	镲	
鑕	锧	
鑞	镴	
鑠	铄	
鑣	镳	
鑥	镥	
鑪	𬬻	
鑭	镧	
鑰	钥	
鑱	镵	
鑲	镶	
鑷	镊	
鑹	镩	
鑼	锣	
鑽	钻	鑚
鑾	銮	
鑿	凿	
钂	镋	
長	长	
門	门	
閂	闩	
閃	闪	
閆	闫	
閉	闭	
開	开	
閌	闶	
閎	闳	
閏	闰	
閑	闲	閒
間	间	
閔	闵	
閘	闸	牐
閡	阂	
閣	阁	閤
閤	合	
閥	阀	
閨	闺	
閩	闽	
閫	阃	
閬	阆	
閭	闾	
閲	阅	
閶	阊	
閹	阉	
閻	阎	
閼	阏	
閽	阍	
閾	阈	
閿	阌	
闃	阒	
闆	板	
闈	闱	
闉	𬮱	
闊	阔	濶
闋	阕	
闌	阑	
闍	阇	
闐	阗	
闑	𫔶	
闒	阘	
闓	闿	
闔	阖	
闕	阙	
闖	闯	
關	关	
闞	阚	
闡	阐	
闢	辟	
闥	闼	
阱		穽
附		坿
陘	陉	
陝	陕	
陣	阵	
陰	阴	隂
陳	陈	
陸	陆	
陽	阳	
隊	队	
階	阶	堦
隑	𬮿	
隕	陨	
際	际	
隤	𬯎	
隨	随	
險	险	
隮	𬯀	
隱	隐	
隴	陇	
隸	隶	𨽻隷
隻	只	
隽		雋
雁		鴈
雇		僱
雍		雝
雕		彫琱鵰
雖	虽	
雙	双	
雛	雏	
雜	杂	襍
離	离	
難	难	
雲	云	
電	电	
霓		蜺
霧	雾	
霸		覇
霽	霁	
靂	雳	
靄	霭	
靆	叇	
靈	灵	
靉	叆	
靚	靓	
面		
靨	靥	
靴		鞾
鞋		鞵
鞍		鞌
鞏	巩	
鞦	秋	
鞽	鞒	
韃	鞑	
韆	千	
韉	鞯	
韋	韦	
韌	韧	靭靱
韍	韨	
韓	韩	
韙	韪	
韜	韬	
韞	韫	
韭		韮
韵		韻
響	响	
頁	页	
頂	顶	
頃	顷	
項	项	
順	顺	
頇	顸	
須	须	
頊	顼	
頌	颂	
頍	𫠆	
頎	颀	
頏	颃	
預	预	
頑	顽	
頒	颁	
頓	顿	
頔	𬱖	
頗	颇	
領	领	
頜	颌	
頠	𬱟	
頡	颉	
頤	颐	
頦	颏	
頫	𫖯	
頭	头	
頰	颊	
頲	颋	
頵	𫖳	
頷	颔	
頸	颈	
頻	频	
頽	颓	穨
顆	颗	
題	题	
額	额	頟
顎	颚	
顒	颙	
顓	颛	
顔	颜	
顗	𫖮	
願	愿	
顙	颡	
顛	颠	
類	类	
顢	颟	
顥	颢	
顧	顾	
顫	颤	
顬	颥	
顯	显	
顰	颦	
顱	颅	
顳	颞	
顴	颧	
風	风	
颭	飐	
颮	飑	
颯	飒	䬃
颱	台	
颳	刮	
颶	飓	𩗗
颸	飔	
颺	飏	
颼	飕	
飀	飗	
飄	飘	飃
飆	飙	
飛	飞	
飢	饥	
飧		飱
飩	饨	
飪	饪	餁
飫	饫	
飭	饬	
飯	饭	
飲	饮	㱃
飴	饴	
飼	饲	飤
飽	饱	
飾	饰	
飿	饳	
餃	饺	
餄	饸	
餅	饼	
餉	饷	饟
養	养	
餌	饵	
餎	饹	
餏	饻	
餑	饽	
餒	馁	
餓	饿	
餗	𫗧	
餘	余	
餛	馄	
餜	馃	
餞	饯	
餡	馅	
館	馆	舘
餳	饧	
餶	馉	
餷	馇	
餼	饩	
餾	馏	
餿	馊	
饁	馌	
饃	馍	饝
饅	馒	
饈	馐	
饉	馑	
饊	馓	
饋	馈	餽
饌	馔	籑
饑	饥	
饒	饶	
饗	飨	
饘	𫗴	
饜	餍	
饞	馋	
饢	馕	
馬	马	
馭	驭	
馮	冯	
馱	驮	䭾
馳	驰	
馴	驯	
馹	驲	
馼	𫘜	
駁	驳	駮
駃	𫘝	
駉	𬳶	
駐	驻	
駑	驽	
駒	驹	
駓	𬳵	
駔	驵	
駕	驾	
駘	骀	
駙	驸	
駛	驶	
駝	驼	駞
駟	驷	
駡	骂	傌罵
駢	骈	
駪	𬳽	
駭	骇	
駰	骃	
駱	骆	
駸	骎	
駼	𬳿	
駿	骏	
騁	骋	
騂	骍	
騄	𫘧	
騅	骓	
騊	𫘦	
騍	骒	
騎	骑	
騏	骐	
騑	𬴂	
騖	骛	
騙	骗	
騞	𬴃	
騠	𫘨	
騤	骙	
騫	骞	
騭	骘	
騮	骝	
騰	腾	
騱	𫘬	
騵	𫘪	
騶	驺	
騷	骚	
騸	骟	
騾	骡	驘
驀	蓦	
驁	骜	
驂	骖	
驃	骠	
驄	骢	
驅	驱	駈敺
驊	骅	
驌	骕	
驍	骁	
驎	𬴊	
驏	骣	
驕	骄	
驗	验	騐
驚	惊	
驛	驿	
驟	骤	
驢	驴	
驤	骧	
驥	骥	
驦	骦	
驪	骊	
驫	骉	
骯	肮	
髏	髅	
髒	脏	
體	体	
髕	髌	
髖	髋	
髮	发	
髯		髥
鬃		騌鬉騣
鬆	松	
鬍	胡	
鬚	须	
鬢	鬓	
鬥	斗	鬦鬪鬭
鬧	闹	閙
鬩	阋	
鬮	阄	
鬱	郁	欝鬰
鬹	鬶	
魂		䰟
魎	魉	
魘	魇	
魚	鱼	
魛	鱽	
魢	鱾	
魨	鲀	
魯	鲁	
魴	鲂	
魷	鱿	
鮀	𬶍	
鮁	鲅	
鮃	鲆	
鮆	𫚖	
鮈	𬶋	
鮊	鲌	
鮋	鲉	
鮍	鲏	
鮎	鲇	
鮐	鲐	
鮑	鲍	
鮒	鲋	
鮓	鲊	
鮚	鲒	
鮜	鲘	
鮝	鲞	
鮞	鲕	
鮟	𩽾	
鮠	𬶏	
鮡	𬶐	
鮣	䲟	
鮦	鲖	
鮪	鲔	
鮫	鲛	
鮭	鲑	
鮮	鲜	尠尟鱻
鮶	鲪	
鮸	𩾃	
鮺	鲝	
鯀	鲧	
鯁	鲠	骾
鯇	鲩	
鯉	鲤	
鯊	鲨	
鯒	鲬	
鯔	鲻	
鯕	鲯	
鯖	鲭	
鯛	鲷	
鯝	鲴	
鯡	鲱	
鯢	鲵	
鯤	鲲	
鯧	鲳	
鯨	鲸	
鯪	鲮	
鯫	鲰	
鯴	鲺	
鯷	鳀	
鯻	𬶟	
鯽	鲫	
鯿	鳊	
鰁	鳈	
鰂	鲗	
鰃	鳂	
鰆	䲠	
鰈	鲽	
鰉	鳇	
鰊	𬶠	
鰍	鳅	鰌
鰏	鲾	
鰐	鳄	鱷
鰓	鳃	
鰛	鳁	
鰜	鳒	
鰟	鳑	
鰣	鲥	
鰤	𫚕	
鰥	鳏	
鰧	䲢	
鰨	鳎	
鰩	鳐	
鰭	鳍	
鰱	鲢	
鰲	鳌	鼇
鰳	鳓	
鰵	鳘	
鰶	𬶭	
鰷	鲦	
鰹	鲣	
鰺	鲹	
鰻	鳗	
鰼	鳛	
鰾	鳔	
鱀	𬶨	
鱂	鳉	
鱅	鳙	
鱇	𩾌	
鱈	鳕	
鱉	鳖	鼈
鱒	鳟	
鱔	鳝	鱓
鱖	鳜	
鱗	鳞	
鱘	鲟	
鱚	𬶮	
鱝	鲼	
鱟	鲎	
鱠	鲙	
鱣	鳣	
鱤	鳡	
鱧	鳢	
鱨	鲿	
鱭	鲚	
鱯	鳠	
鱲	𫚭	
鱸	鲈	
鱺	鲡	
鳥	鸟	
鳩	鸠	
鳬	凫	
鳲	鸤	
鳳	凤	
鳴	鸣	
鳶	鸢	
鳾	䴓	
鴆	鸩	酖
鴇	鸨	
鴉	鸦	鵶
鴒	鸰	
鴕	鸵	
鴛	鸳	
鴝	鸲	
鴞	鸮	
鴟	鸱	
鴣	鸪	
鴦	鸯	
鴨	鸭	
鴯	鸸	
鴰	鸹	
鴴	鸻	
鴷	䴕	
鴻	鸿	
鴿	鸽	
鵁	䴔	
鵂	鸺	
鵃	鸼	
鵏	𬷕	
鵐	鹀	
鵑	鹃	
鵒	鹆	
鵓	鹁	
鵜	鹈	
鵝	鹅	鵞䳘
鵟	𫛭	
鵠	鹄	
鵡	鹉	
鵪	鹌	
鵬	鹏	
鵮	鹐	
鵯	鹎	
鵲	鹊	
鵾	鹍	
鶄	䴖	
鶇	鸫	
鶉	鹑	
鶊	鹒	
鶓	鹋	
鶖	鹙	
鶘	鹕	
鶚	鹗	
鶠	𬸘	
鶡	鹖	
鶥	鹛	
鶩	鹜	
鶪	䴗	
鶬	鸧	
鶯	莺	鸎
鶱	𬸣	
鶲	鹟	
鶴	鹤	
鶹	鹠	
鶺	鹡	
鶻	鹘	
鶼	鹣	
鷀	鹚	鶿
鷁	鹢	
鷂	鹞	
鷄	鸡	雞
鷉	䴘	
鷊	鹝	
鷓	鹧	
鷗	鸥	
鷙	鸷	
鷚	鹨	
鷟	𬸦	
鷥	鸶	
鷦	鹪	
鷫	鹔	
鷭	𬸪	
鷯	鹩	
鷲	鹫	
鷳	鹇	
鷸	鹬	
鷹	鹰	
鷺	鹭	
鸇	鹯	
鸊	䴙	
鸌	鹱	
鸏	鹲	
鸑	𬸚	
鸕	鸬	
鸘	鹴	
鸚	鹦	
鸛	鹳	
鸝	鹂	
鸞	鸾	
鹵	卤	
鹹	咸	
鹺	鹾	
鹽	盐	
麗	丽	
麟		麐
麥	麦	
麩	麸	粰䴸
麯	曲	麴
麴	麹	
麵	面	麪
麻		蔴
麽	么	
黌	黉	
點	点	
黨	党	
黲	黪	
黴	霉	
黶	黡	
黷	黩	
黽	黾	
黿	鼋	
鼉	鼍	
鼓		皷
鼕	冬	
鼹		鼴
齊	齐	
齋	斋	亝
齏	齑	
齒	齿	
齔	龀	
齕	龁	
齗	龂	
齘	𬹼	
齙	龅	
齜	龇	
齟	龃	
齠	龆	
齡	龄	
齣	出	
齦	龈	
齪	龊	
齬	龉	
齮	𬺈	
齯	𫠜	
齲	龋	
齷	龌	
齼	𬺓	
龍	龙	
龐	庞	
龑	䶮	
龔	龚	
龕	龛	
龜	龟	
𡑍	𫭼	
𥗽	𬒗	
𨧀	𬭊	
𨨏	𬭛	
𨭆	𬭶	
𨭎	𬭳